NO ./textures/north.xpm
SO ./textures/south.xpm
WE ./textures/west.xpm
EA ./textures/east.xpm

F 100,100,100
C 225,200,200

11111
10001
10001
10001    
10001
10001
10N01
10001
11111