NO ./textures/north.png
SO ./textures/south.png

WE ./textures/west.png
EA ./textures/east.png

F 100,100,100
C 225,200,200

11111
10001    
100N1    
11111
1     