NO ./textures/north.png
SO ./textures/south.png
WE ./textures/west.png
EA ./textures/east.png

F 100,100,100
C 225,200,200

11111111
10100001
10000101
100E0101    
10000001
10001111
11000001
11111111