NO ./textures/bricks.png
			SO ./textures/eagle.png
WE ./textures/protoblue.png
EA ./textures/switches.png

C 225,         200,-+-200

F      100,100,-+-100

        1111111111111111111111111
        1000000000110000000000001
        1011000001110000000000001
        1001000000000000000000001
111111111011000001110000000000001
100000000011000001111111111111111
11110111111111011100000000001    
11110111111111011101010000001    
11000000110101011100000000001    
10000000000000001100001111001    
10000000000000001100001  1001    
00000000000000001100001111001    
10000000000000001000000000001    
10000000000000001100000000001    
11000001110101011111011110N0111  
11110111 1110101 101111010001    
11111111 1111111 111111111111    
