NO ./textures/north.png
SO ./textures/south.png

WE ./textures/west.png
EA ./textures/east.png

F 100,100,100
C 225,200,200

11111111
10000001
10001111    
100N1     
10001111
10000001    
11111111
