NO ./textures/north.png
SO ./textures/south.png

WE ./textures/west.png
EA ./textures/east.png

F 100,100,100

C 30,144,255






11111111111111111111111111111111111111111111    
10000000000000000000000000000000000000000001    
11111000000000000000000100000000000000000001    
    1000000000000000000000000000000000000001    
    1000000000000000000S00000000000000000001    
    1000000000000000000000000000000000000001    
11111000000000000000000000000000000000000001    
10000000000000000000000000000000000000000001    
11111111111111111111111111111111111111111111    