NO ./textures/bricks.png
SO ./textures/eagle.png
WE ./textures/protoblue.png
EA ./textures/switches.png


F 100,100,100

C 30,144,255






11111    
10001    
10001    
10001    
10001    
10001    
1000111  
10001    
11111    