NO ./textures/north.png
SO ./textures/south.png

WE ./textures/west.png
EA ./textures/east.png

F 100,100,100

C 30,144,255






11111111111111111111111111111111111111111111    
10000000000000000000000000000000000000000001    
10000000000000000000000000000000000000000001    
10011111111000000000000000000000000000000001    
10000000000000000000000000000000000000000001    
10000000000000000000000000000000000000000001    
100000N00000000000000000000000000000000000111  
10000000000000000000000000000000000000000001    
11111111111111111111111111111111111111111111    