NO ./textures/bricks.png
SO ./textures/eagle.png
WE ./textures/protoblue.png
EA ./textures/switches.png

F 100,100,100

C 30,144,255



11111111111111111111111111111111111111111111    
10000000010000000000000000000000000000000001    
10000000010000000000000000000000000000000001    
10000000010000000000000000000000000000000001    
10000000010000000000000000000000000000000001    
100000S0010000000000000000000000000000000001    
10000000010000000000000000000000000000000001    
10000000010000000000000000000000000000000001    
11111111111111111111111111111111111111111111    