NO ./textures/north.png
SO ./textures/south.png

WE ./textures/west.png
EA ./textures/east.png

F 100,100,100
C 225,200,200

1111100000001
10000101 
100N01    
11111      
11111111111